TILEMAP
356 30 							-- Size of tile map in tiles
16 32							-- Tile size & block size
images/blocks.png 	-- Tilesheet
4 9 								-- Number of tiles in tilesheet
555555555555555555555555555555555555555555555555555555555555555555555555555555555555555555555555555555555555555555555555555555555555555555555555555555555555EEEEEEEEEEEEEEEEEEEEEEEEEEEEEEEEEEEEEEEEEEEEEEEEEEEEEEEEEEEEEEEEEEEEEEEEEEEEEEEEEEEEEEEEEEEEEEEEEEEEEEEEEEEEEEEEEEEEEEEEEEEEEEEEEEEEEEEEEEEEEEEE--------------------------------------------------------
552222222222222222222222222222222222222222222225555222222222222222222255555555552222222222222222222222222222222222222222222555555555555555555555555555555555EEEEEEEEEEEEEEEEEEEEEEEEEEEEEEEEEEEEEEEEEEEEEEEEEEEEEEEEEEEEEEEEEEEEEEEEEEEEEEEEEEEEEEEEEEEEEEEEEEEEEEEEEEEEEEEEEEEEEEEEEEEEEEEEEEEEEEEEEEEEEEEE--------------------------------------------------------
-----------------------------------------------2252-------------------2555555552-------------------------------------------555555555555555555552255555555555EEEEEEEEEEEEEEEEEEEEEEEEEEEEEEEEEEEEEEEEEEEEEEEEEEEEEEEEEEEEEEEEEEEEEEEEEEEEEEEEEEEEEEEEEEEEEEEEEEEEEEEEEEEEEEEEEEEEEEEEEEEEEEEEEEEEEEEEEEEEEEEE--------------------------------------------------------
-------------------------------------------------2----------------------2225555-------------------------------------------155555555555555555222--22555555555EEEEEEEEEEEEEEEEEEEEEEEEEEEEEEEEEEEEEEEEEEEEEEEEEEEEEEEEEEEEEEEEEEEEEEEEEEEEEEEEEEEEEEEEEEEEEEEEEEEEEEEEEEEEEEEEEEEEEEEEEEEEEEEEEEEEEEEEEEEEEEEE--------------------------------------------------------
---------------------------------------------------------------------------2252------------------------------------------1555555555555552222-------222555555EEG-------NQT--------------EEEE--PS--EEEEEE--PS--EEEE--------NQT------Y-Y-Y-Y-------FEEEG-------------------FEEEG------------Y-Y-Y-Y-Y-----MEEEE--------------------------------------------------------
------------------------------11---------------------------------------------2-----------------------------------------11555555555552222--------------222555EG--------ORU--------------EEEE------EEEEEE------EEEE--------ORU------Y-Y-Y-Y--------------------------------FEG-------------X-Y-X-Y-X-------MEE--------------------------------------------------------
--------------------------1115251------------------------------------------------------------------------------------1155555555555551--------------------255G---------PS---------------MEEL------EEEEEE------MEEL--------PS-------Y-Y-Y-Y--------------------------------------------------X---X----------ME--------------------------------------------------------
-------------------------552551555---------------------------------------------------------------------------------1155555555522555555--------------------22-------------------------------------MEEEEL---------------------------X-Y-X-Y------------------------------------------------------------------E--------------------------------------------------------
-------------------------221552222------------------------------------------------------------------------------11155555555552--22222-----------------------------------------------------------------------------------------------X---X---------------------------------------------------------------------------------------------------------------------------
---------------------------222-----------------------------------------------------------------------------111115555555555522-------------------------------------------------------------------------------------------------------------------------------8IEH-V--------------------------------------------------------------------------------------------------
--------------------------------------------------------------------------------------------------------5555555555555552222------------------------------------------------------------------------------------------------------------------------------IEEEEEEEEEH------------------------------------------------------------------------------------------------
----------------------------------------------------66----------------------------------------------------5555555222222----------------------------------------------------------------------------------------------------------------------------------FEEEEEEEEEG-----------------------V---V--------------------------------------------------------------------
---------------------------------------------------6666-----------------------------------------------------52222-------------------------------------------------------------------------------IEEEEEED----------------------------------------------------PFEG-X-----------------------V-W-V-W-V------------------------------------------------------------------
------------------------------------------------1116666111-------------------------------------------------------------------------------------------------------------------------------------ETTTTTTTTD--------------------------------------------------------------------------------W-W-W-W-W------------------------------------------------------------------
-----------------------------------------------55525555525111------------------------------------------------------------------------------------------------------------------------------------------OCE----------------------------------------------------------------------IEEEEEEEEEEEEEEEEEEEEEEEEEEH--------------------------------------------------------
------------------------------------------------222333321535555----------------------------------------------------------------------------------------------------------------------------------------7TE----------------------------------------------------------------------FEEEEEEEEEEEEEEEEEEEEEEEEEEG--------------------------------------------------------
---------------------------------------------------3333-2232-----------------------------------------------------------------------------------------------------------------------------------ECCCCCCCCU--------------------------------------------------------------------------------Y-Y-Y-Y-Y------------------------------------------------------------------
----------------------------------------------------33----3-------------------------1-----------------------------------------------------------------------------------------------------------FEEEEEEU----------------------------------------------------8IEH-V-----------------------X-Y-Y-Y-X------------------------------------------------------------------
-------------------------------11-------------------------------------------------5255-------------------------------------------------------------------------------------------------------------------------------------------------------------------IEEEEEEEEEH-----------------------X---X--------------------------------------------------------------------
------------------------------1551-------------------------------------------------5155------------------------------------------------------------------------------------------------------------------------------------------------------------------FEEEEEEEEEG------------------------------------------------------------------------------------------------
-----------------------------155521-----------------------------------------------------------------------------11------------------------------------------1-----------------------------------------------------------------------------------------------PFEG-X--------------------------------------------------------------------------------------------------
----------------------------15555151---------------------------------------------------------------------------1551----------------------------------------15---------------------------------------------------------------------V---V-----------------------------------------------------------------------------------------------------------------------------
---------------------------555555555---------------------------------------------------------------------------55551--------------------------------------155------------------------------------JEEEEK---------------------------W-V-W-V------------------------------------------------------------------E--------------------------------------------------------
----------------------------2552252---------------------------------------------------------------------------1555551-----------------------------------11555H--------8B---------------JEEK------EEEEEE------JEEK--------8B-------W-W-W-W--------------------------------------------------V---V----------JE--------------------------------------------------------
-----------------------------22--2---------------------------------------------------------------------------1555555511-------------------------------1155555EH-------7AD--------------EEEE------EEEEEE------EEEE--------7AD------W-W-W-W--------------------------------IEH-------------V-W-V-W-V-------JEE--------------------------------------------------------
--------------------------------------------------------------------------------------111-------------------155555555551--------------------------11115555555EEH------49C--------------EEEE--8B--EEEEEE--8B--EEEE--------49C------W-W-W-W-------IEEEH-------------------IEEEH------------W-W-W-W-W-----JEEEE--------------------------------------------------------
---------------------------------------------------11-----------------1--------------1555111---------------155555555555511-------------------1111155555555555EEEEEEEEEEEEEEEEEEEEEEEEEEEEEEEEEEEEEEEEEEEEEEEEEEEEEEEEEEEEEEEEEEEEEEEEEEEEEEEEEEEEEEEEEEEEEEEEEEEEEEEEEEEEEEEEEEEEEEEEEEEEEEEEEEEEEEEEEEEEEEE--------------------------------------------------------
------------------------------------11------------1551111-----------1151------------155555551-----------1115555555555555551-------------111115555555555555555EEEEEEEEEEEEEEEEEEEEEEEEEEEEEEEEEEEEEEEEEEEEEEEEEEEEEEEEEEEEEEEEEEEEEEEEEEEEEEEEEEEEEEEEEEEEEEEEEEEEEEEEEEEEEEEEEEEEEEEEEEEEEEEEEEEEEEEEEEEEEEE--------------------------------------------------------
5511111111111111111111111111111111115511111111111155555551111111111155551111111111115555555551111111111155555555555555555551111111111111555555555555555555555EEEEEEEEEEEEEEEEEEEEEEEEEEEEEEEEEEEEEEEEEEEEEEEEEEEEEEEEEEEEEEEEEEEEEEEEEEEEEEEEEEEEEEEEEEEEEEEEEEEEEEEEEEEEEEEEEEEEEEEEEEEEEEEEEEEEEEEEEEEEEEE--------------------------------------------------------
5555555555555555555555555555555555555555555555555555555555555555555555555555555555555555555555555555555555555555555555555555555555555555555555555555555555555EEEEEEEEEEEEEEEEEEEEEEEEEEEEEEEEEEEEEEEEEEEEEEEEEEEEEEEEEEEEEEEEEEEEEEEEEEEEEEEEEEEEEEEEEEEEEEEEEEEEEEEEEEEEEEEEEEEEEEEEEEEEEEEEEEEEEEEEEEEEEEE--------------------------------------------------------
